11111111111
100000000P1
10000C00001
10000000001
11111000001
11111000001
11111111111
