11111111111
10C000000P1
10000000001
1E000000001
11111000001
11111000001
11111111111
11111111111
11111111111
11111111111
