1111111111111111111111111111111
10010000000C0000000010000010001
1000011111000000000010010010101
1P001100000C0000000010010010101
1000011111000000000010010010101
1000011111000000000010010010101
100001111100000000000C010010101
1000011111000000000010010000101
100001111100000000001001ES101C1
1111111111111111111111111111111
